000000000
0001011E0
000111100
0000S0100
000000100